902 902 902 902 902 902 902 902 902 902 902 902 902 902 902 902 902 902 902 902 902 902 902 902 902 902 902 902 902 902 902 902 902 902 902 902 902 902 902 902 
902 902 902 902 902 902 902 902 902 902 902 902 902 902 902 902 902 902 902 902 902 902 902 902 902 902 902 902 902 902 902 902 902 902 902 902 902 902 902 902 
902 902 902 902 902 902 902 902 902 902 902 902 902 902 902 902 902 902 902 902 902 902 902 902 902 902 902 902 902 902 902 902 902 902 902 902 902 902 902 902 
902 902 902 902 902 902 902 902 902 902 902 902 902 902 902 902 902 902 902 902 902 902 902 902 902 902 902 902 902 902 902 902 902 902 902 902 902 902 902 902 
902 902 902 902 902 902 902 902 902 902 902 902 902 902 902 902 902 902 902 902 902 902 902 902 902 902 902 902 902 902 902 902 902 902 902 902 902 902 902 902 
902 902 902 902 902 902 902 902 902 902 902 902 902 902 902 902 902 902 902 902 902 902 902 902 902 902 902 902 902 902 902 902 902 902 902 902 902 902 902 902 
902 902 902 902 902 902 902 902 902 902 902 902 902 902 902 902 902 902 902 902 902 902 902 902 902 902 902 902 902 902 902 902 902 902 902 902 902 902 902 902 
902 902 902 902 902 902 902 902 902 902 902 902 902 902 902 902 902 902 902 902 902 902 902 902 902 902 902 902 902 902 902 902 902 902 902 902 902 902 902 902 
902 902 902 902 902 902 902 902 902 902 902 902 902 902 902 902 902 902 902 902 902 902 902 902 902 902 902 902 902 902 902 902 902 902 902 902 902 902 902 902 
902 902 902 902 902 902 902 902 902 902 902 902 902 902 902 902 902 902 902 902 902 902 902 902 902 902 902 902 902 902 902 902 902 902 902 902 902 902 902 902 
176 176 176 176 176 176 176 176 176 176 176 176 176 176 176 176 176 176 176 176 176 176 176 176 176 176 176 176 176 176 176 176 176 176 176 176 176 176 177 178 
080 080 080 080 132 133 080 080 080 080 080 080 132 133 080 080 080 080 080 080 132 133 080 080 080 080 080 080 132 133 080 080 080 080 134 135 080 080 080 080 
096 096 096 096 148 149 096 096 096 096 096 096 148 149 096 096 096 096 096 096 148 149 096 096 096 096 096 096 148 149 096 096 096 096 150 902 096 096 096 096 
112 112 112 112 112 112 112 112 112 112 112 112 112 112 112 112 112 112 112 112 112 112 112 112 112 112 112 112 112 112 112 112 112 112 166 902 112 112 112 112 
902 902 902 902 902 902 902 902 902 902 902 902 902 902 902 902 902 902 902 902 902 902 902 902 902 902 902 902 902 902 902 902 902 902 902 902 902 902 902 902 
902 902 902 902 902 530 531 902 902 902 902 530 531 902 902 902 902 530 531 902 902 902 902 530 531 902 902 902 902 530 531 902 902 902 902 902 902 902 902 902 
902 902 902 902 902 546 547 902 902 902 902 546 547 902 902 902 902 546 547 902 902 902 902 546 547 902 902 902 902 546 547 902 902 902 902 902 902 902 902 902 
902 902 902 902 902 562 563 902 902 902 902 562 563 902 902 902 902 562 563 902 902 902 902 562 563 902 902 902 902 562 563 902 902 902 902 902 902 902 902 902 
902 902 902 902 902 530 531 902 902 902 902 530 531 902 902 902 902 530 531 902 902 902 902 530 531 902 902 902 902 530 531 902 902 902 902 902 902 902 902 902 
902 902 902 902 902 546 547 902 902 902 902 546 547 902 902 902 902 546 547 902 902 902 902 546 547 902 902 902 902 546 547 902 902 902 902 902 902 902 902 902 
902 902 902 902 902 562 563 902 902 902 902 562 563 902 902 902 902 562 563 902 902 902 902 562 563 902 902 902 902 562 563 902 902 902 902 902 902 902 902 902 
902 902 902 902 902 530 531 902 902 902 902 530 531 902 902 902 902 530 531 902 902 902 902 530 531 902 902 902 902 530 531 902 902 902 902 902 902 902 902 902 
902 902 902 902 902 546 547 902 902 902 902 546 547 902 902 902 902 546 547 902 902 902 902 546 547 902 902 902 902 546 547 902 902 902 902 902 902 902 902 902 
902 902 902 902 902 562 563 902 902 902 902 562 563 902 902 902 902 562 563 902 902 902 902 562 563 902 902 902 902 562 563 902 902 902 902 902 902 902 902 902 
902 902 902 902 902 902 902 902 902 902 902 902 902 902 902 902 902 902 902 902 902 902 902 902 902 902 902 902 902 902 902 902 902 902 902 902 902 902 902 902 
902 902 902 902 902 902 902 902 902 902 902 902 902 902 902 902 902 902 902 902 902 902 902 902 902 902 902 902 902 902 902 902 902 902 902 902 902 902 902 902 
176 176 176 176 176 176 176 176 176 176 176 176 176 176 176 176 176 176 176 176 176 176 176 176 176 176 176 176 176 176 176 176 176 176 176 176 176 176 177 178 
080 080 080 080 132 133 080 080 080 080 080 080 132 133 080 080 080 080 080 080 132 133 080 080 080 080 080 080 132 133 080 080 080 080 080 132 133 080 080 080 
096 096 096 096 148 149 096 096 096 096 096 096 148 149 096 096 096 096 096 096 148 149 096 096 096 096 096 096 148 149 096 096 096 096 096 148 149 096 096 096 
112 112 112 112 112 112 112 112 112 112 112 112 112 112 112 112 112 112 112 112 112 112 112 112 112 112 112 112 112 112 112 112 112 112 112 112 112 112 112 112 
