702 702 702 702 702 702 702 702 702 702 702 702 702 702 702 702 702 702 702 702 702 702 702 702 702 702 702 702 702 702 702 702 702 702 702 702 702 702 702 702 
702 702 702 702 702 702 702 702 702 702 702 702 702 702 702 702 702 702 702 702 702 702 702 702 702 702 702 702 702 702 702 702 702 702 702 702 702 702 702 702 
702 702 702 702 702 702 702 702 702 702 702 702 702 702 702 702 702 702 702 702 702 702 702 702 702 702 702 702 702 702 702 702 702 702 702 702 702 702 702 702 
702 702 702 702 702 702 702 702 702 702 702 702 702 702 702 702 702 702 702 702 702 702 702 702 702 702 702 702 702 702 702 702 702 702 702 702 702 702 702 702 
702 702 702 702 702 702 702 702 702 702 702 702 702 702 702 702 702 702 702 702 702 702 702 702 702 702 702 702 702 702 702 702 702 702 702 702 702 702 702 702 
702 702 702 702 702 702 702 702 702 702 702 702 702 702 702 702 702 702 702 702 702 702 702 702 702 702 702 702 702 702 702 702 702 702 702 702 702 702 702 702 
702 702 702 702 702 702 702 702 702 702 702 702 702 702 702 702 702 702 702 702 702 702 702 702 702 702 702 702 702 702 702 702 702 702 702 702 702 702 702 702 
702 702 702 702 702 702 702 702 702 702 702 702 702 702 702 702 702 702 702 702 702 702 702 702 702 702 702 702 702 702 702 702 702 702 702 702 702 702 702 702 
702 702 702 702 702 702 702 702 702 702 702 702 702 702 702 702 702 702 702 702 702 702 702 702 702 702 702 702 702 702 702 702 702 702 702 702 702 702 702 702 
702 702 702 702 702 702 702 702 702 702 702 702 702 702 702 702 702 702 702 702 702 702 702 702 702 702 702 702 702 702 702 702 702 702 702 702 702 702 702 702 
718 718 718 718 718 718 718 718 718 718 718 718 718 718 718 718 718 718 718 718 718 718 718 718 718 718 718 718 718 718 718 718 718 718 718 718 718 718 718 718 
185 185 185 185 185 185 185 185 185 185 185 185 185 185 185 185 185 185 185 185 185 185 185 185 185 185 185 185 185 185 185 185 185 185 185 185 185 185 185 185 
185 185 185 185 185 185 185 185 185 185 185 185 185 185 185 185 185 185 185 185 185 185 185 185 185 185 185 185 185 185 185 185 185 185 185 185 185 185 185 185 
201 201 201 201 201 201 201 201 201 201 201 201 201 201 201 201 201 201 201 201 201 201 201 201 201 201 201 201 201 201 201 201 201 201 201 201 201 201 201 201 
031 031 031 031 031 031 031 031 031 031 031 031 031 031 031 031 031 031 031 031 031 031 031 031 031 031 031 031 031 031 031 031 031 031 031 031 031 031 031 031 
026 026 026 026 026 026 026 026 026 026 026 026 026 026 026 026 026 026 026 026 026 026 026 026 026 026 026 026 026 026 026 026 026 026 026 026 026 026 026 026 
026 026 026 026 026 026 026 026 026 026 026 026 026 026 026 026 026 026 026 026 026 026 026 026 026 026 026 026 026 026 026 026 026 026 026 026 026 026 026 026 
026 026 026 026 026 026 026 026 026 026 026 026 026 026 026 026 026 026 026 026 026 026 026 026 026 026 026 026 026 026 026 026 026 026 026 026 026 026 026 026 
026 026 026 026 026 026 026 026 026 026 026 026 026 026 026 026 026 026 026 026 026 026 026 026 026 026 026 026 026 026 026 026 026 026 026 026 026 026 026 026 
030 030 030 030 030 026 026 026 030 030 030 030 030 026 026 026 030 030 030 030 030 026 026 026 030 030 030 030 030 026 026 026 030 030 030 030 030 026 026 026 
026 026 026 026 026 026 026 026 026 026 026 026 026 026 026 026 026 026 026 026 026 026 026 026 026 026 026 026 026 026 026 026 026 026 026 026 026 026 026 026 
026 026 026 026 026 026 026 026 026 026 026 026 026 026 026 026 026 026 026 026 026 026 026 026 026 026 026 026 026 026 026 026 026 026 026 026 026 026 026 026 
026 026 026 026 026 026 026 026 026 026 026 026 026 026 026 026 026 026 026 026 026 026 026 026 026 026 026 026 026 026 026 026 026 026 026 026 026 026 026 026 
026 026 026 026 026 026 026 026 026 026 026 026 026 026 026 026 026 026 026 026 026 026 026 026 026 026 026 026 026 026 026 026 026 026 026 026 026 026 026 026 
031 031 031 031 031 031 031 031 031 031 031 031 031 031 031 031 031 031 031 031 031 031 031 031 031 031 031 031 031 031 031 031 031 031 031 031 031 031 031 031 
169 169 169 169 169 169 169 169 169 169 169 169 169 169 169 169 169 169 169 169 169 169 169 169 169 169 169 169 169 169 169 169 169 169 169 169 169 169 169 169 
185 185 185 185 185 185 185 185 185 185 185 185 185 185 185 185 185 185 185 185 185 185 185 185 185 185 185 185 185 185 185 185 185 185 185 185 185 185 185 185 
185 185 185 185 185 185 185 185 185 185 185 185 185 185 185 185 185 185 185 185 185 185 185 185 185 185 185 185 185 185 185 185 185 185 185 185 185 185 185 185 
185 185 185 185 185 185 185 185 185 185 185 185 185 185 185 185 185 185 185 185 185 185 185 185 185 185 185 185 185 185 185 185 185 185 185 185 185 185 185 185 
686 686 686 686 686 686 686 686 686 686 686 686 686 686 686 686 686 686 686 686 686 686 686 686 686 686 686 686 686 686 686 686 686 686 686 686 686 686 686 686 
