937 937 937 937 937 937 937 937 937 937 937 937 937 937 937 937 937 937 937 937 937 937 937 937 937 937 937 937 937 937 937 937 937 937 937 937 937 937 937 937 
937 937 937 937 937 937 937 937 937 937 937 937 937 937 937 937 937 937 937 937 937 937 937 937 937 937 937 937 937 937 937 937 937 937 937 937 937 937 937 937 
937 937 937 937 937 937 937 937 937 937 937 937 937 937 937 937 937 937 937 937 937 937 937 937 937 937 937 937 937 937 937 937 937 937 937 937 937 937 937 937 
937 937 937 937 937 937 937 937 937 937 937 937 937 937 937 937 937 937 937 937 937 937 937 937 937 937 937 937 937 937 937 937 937 937 937 937 937 937 937 937 
937 937 937 937 937 937 937 937 937 937 937 937 937 937 937 937 937 937 937 937 937 937 937 937 937 937 937 937 937 937 937 937 937 937 937 937 937 937 937 937 
937 937 937 937 937 937 937 937 937 937 937 937 937 937 937 937 937 937 937 937 937 937 937 937 937 937 937 937 937 937 937 937 937 937 937 937 937 937 937 937 
937 937 937 937 937 937 937 937 937 937 937 937 937 937 937 937 937 937 937 937 937 937 937 937 937 937 937 937 937 937 937 937 937 937 937 937 937 937 937 937 
937 937 937 396 397 398 399 937 937 937 937 937 937 937 937 937 396 397 398 399 937 937 937 937 937 937 937 937 937 396 397 398 399 937 937 937 937 937 937 937 
937 937 937 412 413 414 415 937 937 937 937 937 937 937 937 937 412 413 414 415 937 937 937 937 937 937 937 937 937 412 413 414 415 937 937 937 937 937 937 937 
937 937 937 428 429 430 431 937 937 937 937 937 937 937 937 937 428 429 430 431 937 937 937 937 937 937 937 937 937 428 429 430 431 937 937 937 937 937 937 937 
937 937 937 444 445 446 447 937 937 937 937 937 937 937 937 937 444 445 446 447 937 937 937 937 937 937 937 937 937 444 445 446 447 937 937 937 937 937 937 937 
937 937 937 460 461 462 463 937 937 937 937 937 937 937 937 937 460 461 462 463 937 937 937 937 937 937 937 937 937 460 461 462 463 937 937 937 937 937 937 937 
937 937 937 476 477 478 479 937 937 937 937 937 937 937 937 937 476 477 478 479 937 937 937 937 937 937 937 937 937 476 477 478 479 937 937 937 937 937 937 937 
937 937 937 937 937 937 937 937 937 937 937 937 937 937 937 937 937 937 937 937 937 937 937 937 937 937 937 937 937 937 937 937 937 937 937 937 937 937 937 937 
937 937 937 937 937 937 937 937 937 937 937 937 937 937 937 937 937 937 937 937 937 937 937 937 937 937 937 937 937 937 937 937 937 937 937 937 937 937 937 937 
937 937 937 937 937 937 937 937 937 937 937 937 937 937 937 937 937 937 937 937 937 937 937 937 937 937 937 937 937 937 937 937 937 937 937 937 937 937 937 937 
937 937 937 937 937 937 937 937 937 937 937 937 937 937 937 937 937 937 937 937 937 937 937 937 937 937 937 937 937 937 937 937 937 937 937 937 937 937 937 937 
937 937 937 937 937 937 937 937 937 937 937 937 937 937 937 937 937 937 937 937 937 937 937 937 937 937 937 937 937 937 937 937 937 937 937 937 937 937 937 937 
937 937 937 937 937 937 937 937 937 937 937 937 937 937 937 937 937 937 937 937 937 937 937 937 937 937 937 937 937 937 937 937 937 937 937 937 937 937 937 937 
937 937 937 937 937 937 937 937 937 937 937 937 937 937 937 937 937 937 937 937 937 937 937 937 937 937 937 937 937 937 937 937 937 937 937 937 937 937 937 937 
937 937 937 937 937 937 937 937 937 937 937 937 937 937 937 937 937 937 937 937 937 937 937 937 937 937 937 937 937 937 937 937 937 937 937 937 937 937 937 937 
937 937 937 937 937 937 937 937 937 937 937 937 937 937 937 937 937 937 937 937 937 937 937 937 937 937 937 937 937 937 937 937 937 937 937 937 937 937 937 937 
937 937 937 937 937 937 937 937 937 937 937 937 937 937 937 937 937 937 937 937 937 937 937 937 937 937 937 937 937 937 937 937 937 937 937 937 937 937 937 937 
937 937 937 396 397 398 399 937 937 937 937 937 937 937 937 937 396 397 398 399 937 937 937 937 937 937 937 937 937 396 397 398 399 937 937 937 937 937 937 937 
937 937 937 412 413 414 415 937 937 937 937 937 937 937 937 937 412 413 414 415 937 937 937 937 937 937 937 937 937 412 413 414 415 937 937 937 937 937 937 937 
937 937 937 428 429 430 431 937 937 937 937 937 937 937 937 937 428 429 430 431 937 937 937 937 937 937 937 937 937 428 429 430 431 937 937 937 937 937 937 937 
937 937 937 444 445 446 447 937 937 937 937 937 937 937 937 937 444 445 446 447 937 937 937 937 937 937 937 937 937 444 445 446 447 937 937 937 937 937 937 937 
937 937 937 460 461 462 463 937 937 937 937 937 937 937 937 937 460 461 462 463 937 937 937 937 937 937 937 937 937 460 461 462 463 937 937 937 937 937 937 937 
937 937 937 476 477 478 479 937 937 937 937 937 937 937 937 937 476 477 478 479 937 937 937 937 937 937 937 937 937 476 477 478 479 937 937 937 937 937 937 937 
937 937 937 937 937 937 937 937 937 937 937 937 937 937 937 937 937 937 937 937 937 937 937 937 937 937 937 937 937 937 937 937 937 937 937 937 937 937 937 937 
