000 000 000 006 000 000 000 006 000 000 000 006 000 000 000 006 000 000 000 006 000 000 000 006 000 000 000 006 000 000 000 006 000 000 000 006 000 000 000 006
000 000 000 006 000 000 000 006 000 000 000 006 000 000 000 006 000 000 000 006 000 000 000 006 000 000 000 006 000 000 000 006 000 000 000 006 000 000 000 006 
000 000 000 006 000 000 000 006 000 000 000 006 000 000 000 006 000 000 000 006 000 000 000 006 000 000 000 006 000 000 000 006 000 000 000 006 000 000 000 006
000 000 000 006 000 000 000 006 000 000 000 006 000 000 000 006 000 000 000 006 000 000 000 006 000 000 000 006 000 000 000 006 000 000 000 006 000 000 000 006
000 000 000 006 000 000 000 006 000 000 000 006 000 000 000 006 000 000 000 006 000 000 000 006 000 000 000 006 000 000 000 006 000 000 000 006 000 000 000 006 
000 000 000 006 000 000 000 006 000 000 000 006 000 000 000 006 000 000 000 006 000 000 000 006 000 000 000 006 000 000 000 006 000 000 000 006 000 000 000 006  
000 000 000 006 000 000 000 006 000 000 000 006 000 000 000 006 000 000 000 006 000 000 000 006 000 000 000 006 000 000 000 006 000 000 000 006 000 000 000 006
000 000 000 006 000 000 000 006 000 000 000 006 000 000 000 006 000 000 000 006 000 000 000 006 000 000 000 006 000 000 000 006 000 000 000 006 000 000 000 006 
000 000 000 006 000 000 000 006 000 000 000 006 000 000 000 006 000 000 000 006 000 000 000 006 000 000 000 006 000 000 000 006 000 000 000 006 000 000 000 006  
000 000 000 006 000 000 000 006 000 000 000 006 000 000 000 006 000 000 000 006 000 000 000 006 000 000 000 006 000 000 000 006 000 000 000 006 000 000 000 006
000 000 000 006 000 000 000 006 000 000 000 006 000 000 000 006 000 000 000 006 000 000 000 006 000 000 000 006 000 000 000 006 000 000 000 006 000 000 000 006 
000 000 000 006 000 000 000 006 000 000 000 006 000 000 000 006 000 000 000 006 000 000 000 006 000 000 000 006 000 000 000 006 000 000 000 006 000 000 000 006  
000 000 000 006 000 000 000 006 000 000 000 006 000 000 000 006 000 000 000 006 000 000 000 006 000 000 000 006 000 000 000 006 000 000 000 006 000 000 000 006
000 000 000 006 000 000 000 006 000 000 000 006 000 000 000 006 000 000 000 006 000 000 000 006 000 000 000 006 000 000 000 006 000 000 000 006 000 000 000 006 
000 000 000 006 000 000 000 006 000 000 000 006 000 000 000 006 000 000 000 006 000 000 000 006 000 000 000 006 000 000 000 006 000 000 000 006 000 000 000 006  
000 000 000 006 000 000 000 006 000 000 000 006 000 000 000 006 000 000 000 006 000 000 000 006 000 000 000 006 000 000 000 006 000 000 000 006 000 000 000 006
000 000 000 006 000 000 000 006 000 000 000 006 000 000 000 006 000 000 000 006 000 000 000 006 000 000 000 006 000 000 000 006 000 000 000 006 000 000 000 006 
000 000 000 006 000 000 000 006 000 000 000 006 000 000 000 006 000 000 000 006 000 000 000 006 000 000 000 006 000 000 000 006 000 000 000 006 000 000 000 006  
000 000 000 006 000 000 000 006 000 000 000 006 000 000 000 006 000 000 000 006 000 000 000 006 000 000 000 006 000 000 000 006 000 000 000 006 000 000 000 006
000 000 000 006 000 000 000 006 000 000 000 006 000 000 000 006 000 000 000 006 000 000 000 006 000 000 000 006 000 000 000 006 000 000 000 006 000 000 000 006 
000 000 000 006 000 000 000 006 000 000 000 006 000 000 000 006 000 000 000 006 000 000 000 006 000 000 000 006 000 000 000 006 000 000 000 006 000 000 000 006  
000 000 000 006 000 000 000 006 000 000 000 006 000 000 000 006 000 000 000 006 000 000 000 006 000 000 000 006 000 000 000 006 000 000 000 006 000 000 000 006
000 000 000 006 000 000 000 006 000 000 000 006 000 000 000 006 000 000 000 006 000 000 000 006 000 000 000 006 000 000 000 006 000 000 000 006 000 000 000 006 
000 000 000 006 000 000 000 006 000 000 000 006 000 000 000 006 000 000 000 006 000 000 000 006 000 000 000 006 000 000 000 006 000 000 000 006 000 000 000 006  
000 000 000 006 000 000 000 006 000 000 000 006 000 000 000 006 000 000 000 006 000 000 000 006 000 000 000 006 000 000 000 006 000 000 000 006 000 000 000 006
000 000 000 006 000 000 000 006 000 000 000 006 000 000 000 006 000 000 000 006 000 000 000 006 000 000 000 006 000 000 000 006 000 000 000 006 000 000 000 006 
000 000 000 006 000 000 000 006 000 000 000 006 000 000 000 006 000 000 000 006 000 000 000 006 000 000 000 006 000 000 000 006 000 000 000 006 000 000 000 006  
000 000 000 006 000 000 000 006 000 000 000 006 000 000 000 006 000 000 000 006 000 000 000 006 000 000 000 006 000 000 000 006 000 000 000 006 000 000 000 006
000 000 000 006 000 000 000 006 000 000 000 006 000 000 000 006 000 000 000 006 000 000 000 006 000 000 000 006 000 000 000 006 000 000 000 006 000 000 000 006 
000 000 000 006 000 000 000 006 000 000 000 006 000 000 000 006 000 000 000 006 000 000 000 006 000 000 000 006 000 000 000 006 000 000 000 006 000 000 000 006   